01 01 01 00 00 00 00 00 00 00 00 00 00 00 00 00 00
01 01 16 00 00 00 00 00 00 00 00 00 00 00 19 00 00
01 00 01 00 00 00 00 00 00 00 00 00 17 00 00 00 00
00 00 00 01 00 00 00 00 00 00 00 00 00 00 00 00 00
00 00 00 00 01 00 00 00 00 00 00 00 00 00 00 00 00
00 00 00 00 00 00 00 00 00 00 00 00 00 00 00 00 00
00 00 00 00 00 00 01 01 01 01 00 00 00 00 00 00 00
00 00 00 00 00 00 01 01 01 01 00 00 00 00 00 00 00
00 00 00 00 00 00 00 00 00 00 00 00 00 00 00 00 00
00 00 00 00 00 00 00 00 00 00 00 00 00 00 00 00 00
01 01 01 01 01 00 00 00 00 00 00 00 00 00 00 00 00
00 00 00 00 00 00 00 00 00 00 00 00 00 00 00 00 00
00 01 01 01 01 00 00 00 01 00 00 00 00 00 00 00 00
00 00 00 00 00 01 00 00 01 00 00 00 00 02 01 00 01
01 01 01 01 01 00 00 00 01 00 00 17 00 00 01 00 01
00 00 00 00 00 00 00 00 01 00 00 00 00 00 01 18 01
00 00 00 00 00 00 00 00 00 00 00 00 00 00 01 01 01